19 25
-------------------------
-------------------------
-------------------------
-------------------------
-------------------------
ooooo---------ooooo------
ooooo---------ooooo------
o---------------oo-------
o-----------------------o
oooo-------------------oo
oooo-------------------oo
--------------oooo-------
--------------oooo-------
----------ooo------------
-------oo-ooo------------
-------oo--------p-------
-------------------------
o------------------------
ooooooooooooooooooooooooo