19 25
-------------------------
-------------------------
-------------------------
-------------------------
c-t-----------tcTt-------
ooooo---------ooooo------
ooooo---------ooooo------
o---------------oo-------
o-----------------------o
oooo-------------------oo
oooo------------c------oo
--------------oooo-------
-----------t--oooo-------
-------c--ooo------------
-------oo-ooo------------
-------oo--------p-------
-------------------------
o---t---tT---ct---tTt--c-
ooooooooooooooooooooooooo